#########################################################################################################################
*   #           #   # #           #                   #     #     #   #           #       #       #           #         #
# # # ##### # # # # # # ##### ##### ### # ########### ### # # ### # # # # ####### ##### # # ### # # ####### # # ####### #
# # # #   # # #   # # #     # #     # # # #     #   #   # # # #   # #   # #   #   #   # # # # # # # #   # # # # # #   # #
# ### # # ### ##### # ##### # # ##### # ### ### # # ### # # ### # # ##### # ### ### # # ### # # ### # # # # ### # # # # #
#   # # #   # # #   #   # # #   #     # #   # # # #     # #   # # # # #   #   # #   # #   #   #     # #   #   # # # # # #
# # # # ### # # # ### # # # ##### ### # # ### # # ####### ### # ### # # ### # # ### # # # ### ####### ### ### # # # # # #
# #   #   #   #       # # #     #   # # #     # # #   #   #   # #   # #   # # #     # # #   # #     #   # # # # #   # # #
# ####### ############# # ##### # ### # ### ### # # # # ### ### # ### ### ### ####### ##### # # ### ### # # # # ##### # #
# #     #           #       #   # #   #   # #   #   #   #   #           # #   #     #     #     # #     #   #   #     # #
# ##### ######### # ######### ##### ### # # # ########### ####### ####### # # # ### ##### # ##### ######### ##### ##### #
#   #     #     # #   #       #     #   # # #       #           # #     # # # #   #       # #   #         #       #   # #
### # # ### ### # ### # ##### # # ### ### # ####### ########### ### ### # # ##### ########### # # ####### ##### ### # # #
#     # #   # # #   # # #   #   # #   #   # #     #           #     #     #     #       #     # #   #   #       #   #   #
# ####### ### # ### # # # # ####### ### ### # ### ########### ############# ### ####### # ##### ### # ########### ##### #
# #     #   # #   # #   # #       #   # #   #   # #   #     #       #     #   #       # # #   # #     #         # # #   #
### ### ### # ### ##### # ####### # # ### ##### # # # ##### ####### # ### ### ##### # # # # ### # ##### ####### # # # ###
#   #   #   #     #   # #   #     # #   #       # # #     #   #   #   # #   #   #   # # # # #   #   #   #     # # # #   #
# ### ### ### ##### # ### # # ##### ### ######### # ##### # # # # ##### ### ### # ### # # # # ####### ### # ### # # ### #
# # # #   # # #     #   # # # #   # #           #   #     # # # #       #   # # # #   #   # #         # # #   # # #   # #
# # # ### # # # ####### ### # # # ### ######### ##### ##### # # ##### ### ### # # ######### ########### # ### # # # # # #
# #       # #   #       #   #   #   #       # # #   #   #   # #   #   #   #     #                   #     #   # # # #   #
# ######### ##### ####### ######### ####### # # # # ### ### # ##### # # ### ############# ### ##### ### ### # # # ### ###
#   #           # #       #       # #       # #   #   #     # #     # #   #   #         # #   #   #   # #   # # #   # # #
# # # ####### ### # ####### ####### # ####### ####### ####### # ##### ### ##### ####### # # ### # ### ### ##### ### # # #
# # #     #   #   # #     #       # #   #             #   #   # #   #   #       #   # # # #   # # #   #   #     #   # # #
### ##### # ### ### # ### ##### # # # # ####### ####### ### ### # ##### ######### # # # # ### # ### ### ### ##### ### # #
#   #   # # #   #       #     # #   # #       #   #       # #   # #   # #     #   # # # #   # # #   #     # #     #     #
# ### # # ### ### ########### # ######### ### ### ### ### # # ### # # # # ### ### # # # ### # # # ####### # ### # # #####
# #   # #       # #     #     # # #     # #   # #   #   # #   #     # #   # #     # # #   # # #         # #   # # # #   #
# # ### ####### ### ### # ##### # # # # ### ### ### ##### ##### ##### ##### ####### # ### ### ######### # ### ### ### # #
# # # # #     #   # # #   #     #   # #     # #   # #     #     #   # #     #     # #   #   #         #     #   #     # #
# # # # # ### ### # # ##### ##### ### ####### # # # # ### # ####### # # # ### ### # # ##### # ####### # ####### # ##### #
#   # # #   # # #   #     # #   #   # #         #   # #   # #     # # # #     #   # #   #   # #       # #     # # #   # #
# ### # ### # # ##### # # # # # ### # ##### ######### ##### ### # # # # ####### ### ### # ### # ####### # # ### # # # # #
# #   #     # #     # # # # # #   # #     #   #     #   #   #   # # #   #     #       # # # # #   #   # # #   # # # #   #
# # ######### ### ### # ### # ##### ##### ### ### # ### # ### ### # ######### ####### # # # # ### # # # # ### # # # #####
# #   #     #   #   # #     #   #   #     # #     #     # #   #                 #   # # # #   #   # #   #   #   # #     #
# ### # ### # # # # # ####### # # ### ##### # ########### # # # ############### # # # # # ##### ### ####### ########### #
#     # # # # # # #   #     # #     # # #     #         # # # # #     #         # # #   #   #   # #     #   #       #   #
##### # # # ### # ##### # # ##### ### # # ##### ####### # # # # # ### ########### # ####### # ### ##### # ##### ### # ###
#     # #   #   #   #   # # #   # #   #   #     #       # # # # # #   #           #   #     #   #       # #     # # #   #
# ##### # ### ##### ### # # # # # # ### ### ##### ####### # # ### # ### ############# # ##### # ##### ### # ##### # # # #
# # #   # #   #   #   # # #   # # #   #   # #   # #   #   # #     #   #     # #     #   #     #     #   #   #     # # # #
# # # ### # ##### ### # # ##### # ### ### # ### # # # # ##### ####### ##### # # ### ##### ######### # ####### ##### # # #
#   # #   # #       # # #     # #   #   # # #   #   #       # #     #     # # # # #     #     #   # # #   #         # # #
##### # ### # ### ### # ##### # ### ### # # # # ########### ### ### # # ### # # # ### # ##### # ### # # # # ########### #
#     # #   #   # #   # #     # #   #   # #   #   # #     #     # #   # #   # #   #   # #       #   # # # # # #         #
# ##### # ##### # # ##### ##### ##### ########### # # ### ####### # ##### ### ### # ##### ####### # ### # # # # ### ### #
#   # # #   #   # #       # #   #   #       #       # # # #       # #     # #   # #       #   #   # #   # # #     # #   #
### # # ### # ### ######### # ### # ### ### # ####### # # ##### # # # ##### # # # ######### ### ### # ### # ##### # #####
#   #   #   #   # #       #   #   #   #   #   #     # # #     # #   #   #   # #   # #       #   #   # # # #   # # # #   #
# ### ### ##### # # ####### ### ##### ######### ### # # ##### # ####### # # # ##### # # ### # # ##### # # ### # # # # # #
#   # #   #     #   #   #   #   #   #         #   #   #   #   #       # # # # #     # #   # # # #     # #   # #   #   # #
### # # ##### ####### # # ### ##### ######### ### ##### ### ######### # # ### # # ### ### # # ### ##### ### # # ####### #
#   #   #     #       #       #     #       #   #   #       #     #   # #   # # #   # #   # #   # #     # #   # #       #
# ####### # ### ############### ### # ##### ### ### ##### ### ### # ### # # # ##### # # ### ### # # ### # ##### # ##### #
# #       #         #     #   #   # #     #         #   #   #   # # #   # #   #   #   # # #   # # # # #   #   # # #   # #
# # ############### # ### # # ### ####### ########### # ### # # # # # ### ##### # ### # # ### # # # # ### # ### # # # ###
# #     #       #   # # #   #   #   #     #         # # # # # # # # # # # #     #   # # #     # # # # #   # #   # # #   #
# ####### ##### # ### # ####### # # # ##### ####### # # # # ### # # # # # ### ##### ### ####### # # # # ### # ### # ### #
#   #     # #   # #   #   #   # # #   #   #   #   #   # #   #   # # # #       #       #   #     #   #   #       # #   # #
### # ##### # ##### ### # # ### # ##### # ### # ####### # ### ##### # ############### ### # ######### ########### # ### #
#   #     # #   #   #   #   #   #       #   # #       # # # #       #     #       # # #   # #     # # #     #   # # #   #
# # ##### # ### # ### ##### # ######### ##### # ##### # # # # ########### # ##### # # # # # # # # # # # ### # # # # # # #
# #   #   #   # # #     # # #   #     # #   # #   #   # # #       #     # # #   # # # # # #   # #   #   # #   # # # # # #
# ##### ##### # # # ### # # ### # ##### # # # ##### # # # # ####### ### # # # # # # # # ####### ######### ##### # # # # #
# #     #     #   #   # #     # #       # # #       # # # # #     # # # #   # #   # # #   #     #         # #   # # # # #
# # ##### # ######### # ####### # ####### # ######### # # ### ### # # # # ### ##### # ### # ### # ##### # # # ### # # ###
# #     # #         # #   #     #   #     #         # # #     # #   # # # #   #           # #   #   #   # # #   #   #   #
# ##### ##### ##### # ### # ####### # ####### ##### # # ####### ##### # # # ############# # # ### ### ### # ### ####### #
#     #     # #   # # # # # #       # #   #   #   # # # #     #         # #         #     # # #   #   #       # #       #
### # ##### # # # ### # # # ####### # # # # ### # ### # ### ### ############# ##### # ##### ### ### ########### # #######
#   #     # #   #       # #       # # # # #   # #     #   #   # #   #       # #   # #     #   #   #     #       #       #
# # ####### # ######### # ####### # # # # ### # ######### ### # # # # ### # ### # # ##### ### ### ##### # ########### # #
# # #       # # #     # #     #   # # # #   #   #       #   # # # # #   # #     # #   #   #   #   # #   #     #     # # #
# ### ####### # # ### # ### # # ##### # ### ##### ##### # # # # # ##### # ####### ### # ### ### ### # ####### # ### ### #
# #   # #     # # # # # #   # #     # #   #   #   #   # # # # # #       #   #   # #   # #   #   #   # #     # #   #     #
# # ### # ##### # # # # # ### ##### # ### ##### ##### # ### # # # ######### # # # # ### # ### ##### # # # ### ### ##### #
# #   #         # #   # # #   #   #       #     #   #   #   # # # #       #   # #   #   # #         #   #   #     #   # #
# ### ######### # # ##### # ### # ######### ##### # # ### ### # # # # ######### ##### ### # ####### ####### ####### ### #
#   #       #   # # #     # # # #   # #     #     # #     #   # # # #   #     #     # # #   # #   # # #         #   #   #
# ######### ##### # # ##### # # # # # # ##### ##### ######### # # ##### # ### ##### # # ##### # # # # # ##### ### # # ###
#         #   #   # #   # # # # # #   #       #   #   #       # #       #   # #     #   #     # # #   # #   # #   #   # #
# ##### # ### # ### ### # # # # # ### ########### ### ### ### # ####### ### # # ####### # ### # # ##### # # # # ####### #
#   #   #   #   #   #   # # #   # # #     #     #   #   #   # #   #       # #   #   #   # #   # #   #   # #   #         #
### # ##### ##### ### ### # ##### # ##### # ### ### ### # # # ### # ####### ####### # ##### ### ### # ######### ####### #
#   # #         # #   #     #     #     # # #     # #   # # #   # #     #   #       # #     #   #   # #   #     #     # #
# ### ##### ##### # ### ##### ##### ##### # ##### # # ### # ### # ##### # ##### # ### ### ### ### ### # # # ##### ### # #
# # # #   # #   #   # #   #   #     #     #   #     #   # # # # # # #   #     # # #       #     #   #   #   #       # # #
# # # # # ### # ##### ### ### # ##### ####### ######### ### # # # # # ####### ### # ####### ####### # ####### ####### ###
#   #   #     #   #     # #   # #     #     # #       # #   #   # #         #   # #   #     #   #   # #     # #     #   #
### ############# # # ### # ### # ##### ### # # ##### # # ##### # ######### ### # ### # ##### # # ### # ### # # ### ### #
# #   #         #   # #   # #   #   #   #   # # #   #   #     # #         #   # #     # #     #   #   # # # # # #       #
# ### # # # ######### # ### ### ### # ### ### # # ### ####### ########### ### # ####### # ##### ####### # # # # # #######
#     # # # #   #     #   #   #       # #   # # #   # #     # #       #   # # # #       #     # #       # #   # #   #   #
# ####### ### # # ### ### # # ######### ### # # ### # # ### # # ### ### ### # # # ########### # # ####### ##### ##### # #
#         #   #   #     # # #   #   #         #   #   # #   #   #   #   #     # # #   #     # # # #       #   #   #   # #
##### ##### ### ######### ##### # # # ##### ##### # ### # ### ### # # ######### # # ### # ### ### # # ### # # ### # ### #
# #   #   #   # #       # #   #   # # #   # #     # #   # #   #   # # #         # #     # #   #   # # #   # # #   #   # #
# # ### # ### # # ##### # # # ##### ### # # # ##### # ### ##### ##### # # ####### ####### # ### ##### # ### # # ##### # #
#   #   #     # # #     # # #       #   # # # #     #   # #   #         # #       #     # #   #   #   # #   # # #     # #
# ### ########### # ##### # ######### ### ### ######### # # # ############# ####### ### # ### ### # ### ##### # # ##### #
# #   #           # #     #   #       #       #       # #   #       #       #       # # #   # #   # # # #   # #   # #   #
### ### ########### # ####### # ####### ####### ##### # ########### # ####### ####### # ### # # ### # # # # # ##### # ###
#   #   #   #     #   #       #   #   # #     # #     # #   #     #   #             # # #   #   #   # #   #     #   #   #
# # # ### ### ### ##### ### # ### ### # # ### # # ### # # # ### # ########### ##### # # # ######### # ######### # # ### #
# # # #       #   #     #   #   # #   # #   #   # #   #   #   # # #   #     #     # #   #           #   #     # # # #   #
# # # # ####### # ##### # ##### # # ### ### ##### # ######### # # # # # ### ####### # ######### ##### # # # ### ### # # #
# # # #     #   #     # #   #   # #     #     #   #   #   #   # #   #   # #   #   # # #   #   # # #   #   #     #   # # #
# # # ##### # ####### ##### # ### # ##### ##### ##### # ### ### ######### ### # # # # # # # # # # # ############# ### ###
# # #   #   #     #   #     #   # # #   # # #   #   #   #   #   # #         #   #   # # #   #   #   #       #       #   #
# ##### ######### # ### ### ##### # # ### # # ### # ### # ##### # # ##### # ######### # ######### ##### ### # ##### ### #
# #   #           # #     # #   # # #   # # #     #   # #     # #     # # #   #     #   #       # #   # #   #   #     # #
# # # ############# # ### ### # # # # # # # ######### ####### # ##### # # ##### ### ##### ##### # # # # # ####### ##### #
# # #     #       # # #   #   #   # # # #   #         #   #   #     # # #       # #     #   #   #   #   # #       #     #
# # ### # # ##### # ### ### ####### ### ### # ######### # # ##### # # # ######### ### # ### # ########### # ##### # ### #
#   # # # #   #   #   #   #     #         # #       #   # # #   # # # #     #     # # #   # # #         # #   # # # #   #
# ### # ##### # ##### ### ##### ########### ####### # ### # # # ### # ### # ### # # # ##### # # # ####### ### # # # #####
#     #       #               #                   #     #     #     #     #     #   #       #   #             #   #    o#
#########################################################################################################################
